11111111111111111111
1      2           1
1   2222222222222  1
1      2           1
1      2    2     11
11111      2       1
1          2      11
1  2       2     111
1  2               1
11111111111111111111